1111111111111111111
1000000001000000001
1211011101011101121
1000000000000000001
1011010111110101101
1000010001000100001
1111011131311101111
3331013333333101333
1111013116113101111
1733033153513303381
1111013111113101111
3331013333333101333
1111013111113101111
1000000001000000001
1011011101011101101
1201000004000001021
1101010111110101011
1000010001000100001
1011111101011111101
1000000000000000001
1111111111111111111
